111111111111111
1P0001C00010001
1000000000000E1
110111101111011
100000000000001
1C0001C000100C1
111111111111111