1111111111
1P000000C1
1000111001

100C0000E1
1111111111
