11111111111111111111
1P000000000000000001
11111111111111111101
1C000000000000000001
10111111111111111111
100000000000000000C1
11111111111111111101
1C000000000000000E01
10111111111111111111
1000000000C000000001
11111111111111111111