1111111111111
1P000000000C1
1011111011101
101C00000C101
1010111110101
101010E010101
1010111010101
101C000000101
1011101111101
1C00000000001
1111111111111