11111111111
1P0010000C1
10101011101
10100000001
10111011101
1C00000E101
11111111111